0000000000000
01--------200
0|        |00
0|        |00
0|        320
0|         |0
0|         |0
0|         |0
0|        140
0|        |00
03--------400
0000000000000